N,N,N,N,M,M,M,M,M,N,N,N,N,N,N,N,N,N,N
N,N,N,N,M,V,V,V,M,N,N,N,N,N,N,N,N,N,N
N,N,N,N,M,C,V,V,M,N,N,N,N,N,N,N,N,N,N
N,N,M,M,M,V,V,C,M,M,N,N,N,N,N,N,N,N,N
N,N,M,V,V,C,V,C,V,M,N,N,N,N,N,N,N,N,N
M,M,M,V,M,V,M,M,V,M,N,N,N,M,M,M,M,M,M
M,V,V,V,M,V,M,M,V,M,M,M,M,M,V,V,D,D,M
M,V,C,V,V,C,V,V,V,V,V,V,V,V,V,V,D,D,M
M,M,M,M,M,V,M,M,M,V,M,J,M,M,V,V,D,D,M
N,N,N,N,M,V,V,V,V,V,M,M,M,M,M,M,M,M,M
N,N,N,N,M,M,M,M,M,M,M,N,N,N,N,N,N,N,N