N,N,M,M,M,M,M,N
M,M,M,V,V,V,M,N
M,D,J,C,V,V,M,N
M,M,M,V,C,D,M,N
M,D,M,M,C,V,M,N
M,V,M,V,D,V,M,M
M,C,V,R,C,C,D,M
M,V,V,V,D,V,V,M
M,M,M,M,M,M,M,M
