N,M,M,M,M,M,M,M,M,M,M,M,M,M,M,M,M,M,N
N,M,D,D,D,V,V,V,M,V,V,V,V,M,V,V,V,M,M
M,M,D,D,D,D,D,V,V,C,M,M,V,M,V,M,C,V,M
M,D,D,D,D,D,D,M,V,V,C,V,V,M,V,V,V,V,M
M,D,D,D,D,D,D,M,V,V,M,V,V,M,V,M,V,V,M
M,M,M,M,M,M,M,M,M,V,C,V,V,C,V,C,V,V,M
N,N,M,V,V,V,V,V,M,C,M,M,C,V,M,M,C,M,M
N,M,M,V,V,V,C,V,V,V,V,M,V,C,V,V,V,V,M
N,M,V,V,M,M,V,M,M,M,V,M,V,V,M,M,C,V,M
N,M,V,C,V,C,C,V,V,V,V,V,C,V,V,C,V,V,M
N,M,V,C,V,V,V,V,C,M,M,C,V,M,M,M,M,M,M
N,M,M,M,M,M,M,M,V,V,J,V,M,M,N,N,N,N,N
N,N,N,N,N,N,N,M,M,M,M,M,M,N,N,N,N,N,N